wwwwwwwwwwwwwwwwwwwwwwww
w......w...............w
w..c.....g...c....w..A.w
w......................w
w..w...........w.......w
w.c....w.........c.....w
w.........cw...........w
w....w.................w
w....c.......w...c.....w
w.c.................c..w
wwwwwwwwwwwwwwwwwwwwwwww
