wwwwwwwwwwwwwwwwwwwwwwwwwwwwwwwwwwwwwwwwwwwwwwww
w.............................................gw
wn............................................gw
w.............................................gw
whwww.wwwww.wwwww.www.ww......................gw
wh.....................w......................gw
wh.....................w......................gw
wA.....................w......................gw
wwwwwwwwwwwwwwwwwwwwwwwwwwwwwwwwwwwwwwwwwwwwwwww
