.........ddddd.......
.........d ..d.......
.........d.A.d.......
.........d...d.......
.........ddddd.......
....................1
.......t.............
