wwwwwwwwwwwwwwwwwwwwwwwwwwww
+++++w+g+w++++++++++++++++++
000==00==00===0==0=====0=0=4
00000====000==00==0====00=32
000===000===000====0==0===04
www+++ww+++www++++www++wwwww
....x.x.....xx...x..x..x....
..--..--..--..--.-...--.-...
..xx.....x......xx.x..x..xx.
w+++++++A++++++++++++++++++w
wwwwwwwwwwwwwwwwwwwwwwwwwwww
