wwwwwwwwwwwwwwwwwwwwwwwwwwww
+++++++++++w+g+w++++++++++++
000==000000===0000=====000=2
00000====0000000000====00012
000===000===000====0000===02
www+++ww+++www++++www++wwwww
....----...---...-..----....
.-.....xxx.......xxx....xx..
..-...---.....-...----.--...
w+++++++A++++++++++++++++++w
wwwwwwwwwwwwwwwwwwwwwwwwwwww
