wwwwwwwwwwwwwwwwwwwwwwwwwwww
+++++++++++w+g+w++++++++++++
000==000000============000=2
00000==================00012
000===000=============0===02
www+++ww++++++++++www++wwwww
w==========================w
w==========================w
w+++++++=====A=============w
wwwwwwwwwwwwwwwwwwwwwwwwwwww
