wwwwwwwwwwwwwwwwwwwwwwww
w.f........m....m.....fw
w......................w
wwwwww.................w
w......................w
w...................wwww
w......................w
w...........A..........w
w..www.........www.....w
w..w............w......w
w..w............w......w
w..w..c.....c...w..c...w
wwwwwwwwwwwwwwwwwwwwwwww
