wwwwwwwwwwwwwwwwwww
w+++++++++++r++++2w
w+r+++++++r+++++++w
w+++++++++++++++++w
w+++++++++++++++++w
w+++r+++++A+++r+++w
wwwwwwwwwwwwwwwwwww
w+++++++++++++++++w
w+++h+v+h+v+h++v++w
w3+++++++++++++++gw
wwwwwwwwwwwwwwwwwww
