1..........
00.........
00.........
...........
...........
...........
...........
....000....
...0   0...
... ... ...
.....A.....