wwwwwwwwwwwwwwww
w...o.xx.o.....w
w...oooooo.....w
w....xxx.......w
wx.............w
wwwwwwwwwww....w
w......o.......w
w..........Ao..w
w..............w
w......x....wwww
w........x..ooxw
w.....e........w
wwwwwwwwwwwwwwww