wwwwwwwwwwwww
wA....1i001gw
w.11111u001.w
w1100000001.w
w0001111111.w
w1111..  ...w
w......11111w
w11111110001w
wm0000000000w
w0000000010kw
wwwwwwwwwwwww