wwwwwwwwwwwww
w+...w....g.w
w...www.....w
w.1..www....w
w..wwwwwww..w
w......w+...w
w....w...1..w
wA...w+...1.w
wwwwwwwwwwwww
