wwwwwwwwwwwwwwwwwww
w+.+...+w+++...+++w
w+++-++w+w++12+..+w
w+.++-+w+++.++++++w
w++++++w++w+++..+0w
w+++w+++w+++-+-+++w
w+.+.++++w++w+.+++w
w++-++2++-+w++++++w
w++++1++w+1+++++++w
w+++---+.........Aw
wwwwwwwwwwwwwwwwwww
