wwwwwwwwwwwwwwwwwwwwwwwwwwww
+++++++++++w+g+w++++++++++++
0000000000000000000000000000
0000000000000000000000000000
w+++++++++++++m++m++++m++++w
w+++++++++++++++++++m++++++w
0000000000000000000000000000
w+++++++++m+++++++A++++++++w
0000 00000 0000000 0000 0000
w                          w
wwwwwwwwwwwwwwwwwwwwwwwwwwww
