..ff.............ff..
..ff.............ff..
..ff......A......ff..
..ff.............ff..
..ff.............ff.1
2.ff.............ff..
..ff.............ff.1
2.ff.............ff..
..ff......3......ff..
