wwwwwwwwwwwwwwwwwwwwwwwwwwww
w.........A................w
w....0.....................w
w...................0......w
w............0.............w
wwwwwwwwwwwww.wwwwwwwwwwwwww
w..0...............0....w..w
w.....1...1.1..1.......w...w
w.0.............0.....w..0.w
w....1..1..1.........w.0...w
w............0......w..0...w
wwwwwwwwwwwwwwwwwwwwwwwwwwww