wwwwwwwwwwwwwwwwwwwwwwww
w......................w
w..c...w..w..c.....c...w
w.......c...n....w.....w
w...w..rrrr............w
w......r.Ar......c.....w
w......rrrrc...........w
w....w...wwwwwww.......w
w....c........n....g...w
w......................w
wwwwwwwwwwwwwwwwwwwwwwww
