.................ff..
.................ff..
.......... ......ff.1
.................ff.1
.................ff.1
.................ff.1
........A........ff.1
.................ff.1
............3....ff..
