wwwwwwwwwwwwwwwwwwwwwwwwwwww
++++++++++++wgw+++++++++++++
0000000000000000000000000000
0000000000000000000000000000
w+++++++++++++ ++ ++++ ++++w
w+++++++++++++++++++ ++++++w
0000000000000000000000000000
w+++++++++ ++++++++++++++++w
0000 0000 00    00 0000 0000
w                         Aw
wwwwwwwwwwwwwwwwwwwwwwwwwwww
