wwwwwwwwwww
w...w.....w
w.w01.ww.1w
w...1.....w
wwwww02...w
ww.......2w
ww..w..w.Aw
ww..w..w.0w
wwwwwwwwwww