wwwwwwwwwwwwwwwwwwwwwwww
w.f...f....m....m.....fw
w....................f.w
wwwwww.................w
w......................w
w...................wwww
w......................w
w...........A..........w
w..www.........hhh.....w
w..w............h......w
w..w............h......w
w..w..c.....c...h..c...w
wwwwwwwwwwwwwwwwwwwwwwww
