wwwwwwwwwwwwwwwwwww
wA++w++++++++w3++4w
wo+iw++++++++wx+++w
wwwww++++++o+wwwwww
w+++w+w+c++++++w+ow
wg++w+wwwwwww++++ww
w++5w++++++++h++++w
wwwww+++++www+++++w
w++++++++++i++++++w
www2w+++v++++x++www
wwwwwwwwwwwwwwwwwww
