wwwwwwwwwwwww
w..1.ww....Aw
w....w......w
w.w.....wwwww
w+w........1w
w.w..wwwwwwww
w.......w...w
w...1w....wgw
wwwwwwwwwwwww
