wwwwwwwwwwwwwwwwwwwwwwww
w....f..m..f....f.m.f..w
w......................w
w......................w
w......................w
w......................w
w......................w
w...........A..........w
w......................w
w...........h..........w
w...........h..........w
w...c.......h......c...w
wwwwwwwwwwwwwwwwwwwwwwww
