wwwwwwwwwwwwwwwwwww
w++++++5w+++++++++w
w++i++++wi+++++o+Aw
w+++++++w++3++++++w
w++++wwwwwwwwwwwwww
w+++++++++++w+2+++w
wwwww+++w+c+w+++5+w
w+3+w+++w+++wwwwwww
w+++w+++o++++++4++w
wg++w+++w+++++++++w
wwwwwwwwwwwwwwwwwww
