wwwwwwwwwwwwwwwwwwwwwwww
w......r....r..........w
w..w...r.A..rw....c..g.w
w......rrrrrr..........w
w..n...........c.......w
w.w....c.........w.....w
w.........wc...........w
w....c.............n...w
w....w.......c...w.....w
w.w....n............w..w
wwwwwwwwwwwwwwwwwwwwwwww
