wwwwwwwwwwwwwwwwwwwwwwww
w......................w
w..c.........n.....c...w
w.......c..............w
w......................w
w........A.......c.....w
w..........c...........w
w......................w
w....n.............g...w
w......................w
wwwwwwwwwwwwwwwwwwwwwwww