..ff.............ff..
..ff.............ff..
2.ff.............ff.1
2.ff.............ff.1
2.ff.............ff.1
2.ff.............ff.1
..ff....A........ff.1
2.ff.............ff..
..ff.........3...ff..
