wwwwwwwwwwwwwwwwwwwwwwwwwwww
w..............1.0.......0.w
w..0000......0.1...0......0w
w...00......1..1..www......w
w..w...0..1................w
w00w...1wwwwww1ww......A...w
w..w......1...0............w
w...00......1..1..www...0..w
w..0000.0......1..........0w
w.........0....1.........0.w
wwwwwwwwwwwwwwwwwwwwwwwwwwww