..f...............f..
..f...............f..
2.f...............f.1
2.f...............f.1
2.f...............f.1
2.f...............f.1
..f.....A.........f.1
2.f...............f..
..f..........3....f..
