wwwwwwwwwwwwwwwwwwwwwwww
w......................w
w..c...w..w..c.....c...w
w.......c....n....w....w
w...w..................w
w........A.......c.....w
w..........c...........w
w....w...wwwwwww.......w
w....c........n....g...w
w......................w
wwwwwwwwwwwwwwwwwwwwwwww
