wwwwwww
wkwwwww
w0iu..w
w0m01.w
w0111.w
w.1A1.w
w01.1.w
wwwwg.w
wwwwwww