wwwwwwwwwwwwwwwwwww
w+.+...+w+++...+++w
w+++-++w+w++1++..+w
w+.++-+w+++.++++++w
w++0+++w++w+++..++w
w+++w+++w+++-+-+++w
w+.+.++++w++w+.+++w
w++-++2++-+w++++++w
w+++01++w+1+++++++w
w+++----+........Aw
wwwwwwwwwwwwwwwwwww
