wwwwwwwwwwwwwwwwwwwwwwwwwwww
++++++++++++wgw+++++q+++++++
00===0========0============2
00000==000000000000000000002
000=0000000000000000000===12
+++++++++++++++++++++++++++w
00===0=0000000000000000====2
++p++++++++++++++++++++++++w
00000000000000000=B=00000000
wwwwwwwwwwwwwwwwwwwwwwwwwwww
