..ff.................
..ff.................
2.ff.................
2.ff.................
2.ff.........A.......
2.ff.................
2.ff.................
2.ff.................
..ff..............3..
