wwwwwwwwwwwwwwwwwwwwwwww
w......................w
w..c.........n.....c...w
w.......c..............w
w......rrrrr...........w
w......r.A.r.....c.....w
w......r...rc..........w
w......rrrrr...........w
w....n.............g...w
w......................w
wwwwwwwwwwwwwwwwwwwwwwww