wwwwwwwwwwwwwwwwwwwwwwwwwwww
w00w.......................w
w00w...0........0....1.....w
w00w......1................w
w.ww..........1.0..1...1...w
w......0..............1..0.w
w...........1...0......1...w
w...0....0...0....1.1.....0w
w......................wwwww
w.....A..................00w
wwwwwwwwwwwwwwwwwwwwwwwwwwww