wwwwwww
wkwwwww
w001.lw
w0m00.w
w0111.w
w.1A1.w
w01.1.w
wwwwg.w
wwwwwww