wwwwwwwwwwwwwwwwwwwwwwwwwwww
+++++++++++w+g+w++++++++++++
0000000000000000000000000000
0000000000000000000000000000
w+++++++++++++ ++ ++++ ++++w
w+++++++++++++++++++ ++++++w
0000000000000000000000000000
w+++++++++ +++++++A++++++++w
0000 00000 0000000 0000 0000
w                          w
wwwwwwwwwwwwwwwwwwwwwwwwwwww
