wwwwwwwwwwwww
w04......w..w
w34.1.4.....w
w...A.1.w.0ww
www.w1..wwwww
w2..4...w.0.w
w.1.4......ww
w..........ww
wwwwwwwwwwwww