wwwwwwwwwwwwwwwwwwwwwwww
w.....0................w
w......w.0....w.0......w
w...w.......0.ww.......w
w.....w............w...w
w...g...0...w....0.g...w
w.....w....w...w..w....w
w.......w.......w......w
w...w.....w.....w..0...w
w......0......A........w
wwwwwwwwwwwwwwwwwwwwwwww