wwwwwwwwwwwww
wA....10001gw
w.111110001.w
w1100000001.w
w000111111d.w
w1111.......w
w......11111w
w11111110001w
wm0000000000w
w0000000010kw
wwwwwwwwwwwww