wwwwwwwwwwwwwwwwwww
w1+++w+.+.+++++A++w
w++-+w+.++.+++++++w
w++++w+++w+++wwwwww
w+++++++0w+++..++1w
w+...++www+++..+++w
w++++++++wwww+++++w
w+++w++++w+++++.+.w
w+++w++..+++w+++..w
w-+-w2++..++wwwwwww
wwwwwwwwwwwwwwwwwww