wwwwwwwwwwwwwwwwwww
wA++.++++++++..++1w
w.+.+++++++++..+++w
wwwww++++++++wwwwww
w+++++w+.0+++++w1+w
w+++-+wwwwwww++++ww
w++.++++++++++++++w
wwwww+++++www+++++w
w++1w+++++++++++++w
w++++++++...++++www
wwwwwwwwwwwwwwwwwww