wwwwwwwwwwwwwwwwwwwwwwww
w....m..m..m.m..m...m..w
w......................w
w......................w
w......................w
w......................w
w......................w
w...hhhhhhhhhhhhhhhh...w
w......................w
w...........A..........w
w......................w
w.....c.....c......c...w
wwwwwwwwwwwwwwwwwwwwwwww
