wwwwwwwwwwwwwwwwwwwwwwww
w......................w
w..n...w.....c.....w.A.w
w.......c......w.......w
w..w...............w...w
w.n..............n.....w
w..........w...w...w...w
w....w.................w
w....g...w.......c.....w
w...........w..........w
wwwwwwwwwwwwwwwwwwwwwwww
