..f..................
..f..................
2.f..................
2.f..................
2.f..........A.......
2.f..................
2.f..................
2.f..................
..f...............3..
