wwwwwwwwwwwwwwwwwwwwwwwwwwww
w..1...0.1..w...0.0.0.0w000w
w.1..0....0............w000w
w...1...0.....A........w000w
wwwwwwwwwwww.............00w
w0....0.......0.....w.....ww
w0......1..............0...w
w0....0....wwwww....1..0..0w
wwwww................w.....w
w........0.0.0.0.0...w0...0w
wwwwwwwwwwwwwwwwwwwwwwwwwwww