..................f..
..................f..
.......... .......f.1
..................f.1
..................f.1
..................f.1
........A.........f.1
..................f.1
............3.... f..
