wwwwwwwwwwwwwwwwwww
w++++++5w+++v+++++w
w++i++++wi+++++o+Aw
w+++++++w++3++++++w
w++++wwwwwwwwwwwwww
w++h++++++++w+2+++w
wwwww+++w+++w+++5+w
w+3+w+++w+++wwwwwww
w+++w+v+o++++++4++w
wg++w+++w+++++++++w
wwwwwwwwwwwwwwwwwww
