wwwwwwwwwwwwwwwwwwwwwwww
w..m.f..m.m.m..m.f.m...w
w......................w
w......................w
w......................w
w......................w
w......................w
w...........A..........w
w......................w
w.......hhhhhhhhh......w
w......................w
w...........c..........w
wwwwwwwwwwwwwwwwwwwwwwww
