wwwwwwwwwwwwwwwwwwwwwwwwwwww
w..w0w........0........w0w.w
w.........0.....0..........w
w...1...w...1.....www.....1w
w.0...1.w....1.1...1.......w
w0....0..w..0........0....0w
w.........1...wwww...1.....w
w....1........w.1......10..w
w.........A........0.......w
w..w0w........0........w0w.w
wwwwwwwwwwwwwwwwwwwwwwwwwwww