..f...............f..
..f.......A.......f..
..f...............f.1
2.f...............f..
..f...............f.1
2.f...............f..
..f...............f.1
2.f...............f..
..f.......3.......f..
