wwwwwwwwwwwwwwwwwwwwwwww
w......w..........r....w
w..n.....g...c....w..A.w
w.................r....w
w..w...........w..rrrrrw
w.n....w.........n.....w
w.........cw...........w
w....w.................w
w....c.......w...c.....w
w.c.................c..w
wwwwwwwwwwwwwwwwwwwwwwww
