wwwwwwwwwwwwwwwwwwwwwwww
w......w...............w
w..w.....A...w....c..g.w
w........c.............w
w..n...........c.......w
w.w....c.........w.....w
w.........wc...........w
w....c.............n...w
w....w.......c...w.....w
w.w....n............w..w
wwwwwwwwwwwwwwwwwwwwwwww
