wwwwwwwwwwwww
w...00.00..lw
w.w100k001w.w
w.w.00000.w.w
w.1.00m00.1.w
w.w.ww1ww.w.w
w1..........w
w.wwww1wwww.w
w.....Ag....w
wwwwwwwwwwwww