wwwwwww
wAwow.w
w.wx.nw
w..wxxw
wcc.c.w
w..w..w
wxcx..w
w..n..w
wwwwwww