wwwwwwwwwwwwwwwwwwwwwwww
w..................r...w
w..n...w.....c.....w.A.w
w.......c......w...r...w
w..w...............wrrrw
w.n..............n.....w
w..........w...w...w...w
w....w.................w
w....g...w.......c.....w
w...........w..........w
wwwwwwwwwwwwwwwwwwwwwwww
